++++++++++++++++++++++++++++++++++++++++++++++++++++++++++++++++++
+           +                   +            +                   +
+++++++++   +   +++++++++++++   ++++++++++   +   +++++++++++++   +
+           +   +       +       +            +   +       +       +
+   +++++++++   +++++   +   ++++++   +++++++++   +++++   +   +++++
+           +       +   +       +            +       +   +       +
+++++++++   +++++   +   +++++   ++++++++++   +++++   +   +++++   +
+   +       +   +   +   +            +       +   +   +   +       +
+   +   +++++   +   +   +   +   +    +   +++++   +   +   +   +   +
+   +   +               +   +   ++   +   +               +   +   +
+   +   +++++++++++++++++   +   +    +   +++++++++++++++++   +   +
+       +           +       +            +           +       +   +
+   +++++   +++++   +   +++++   ++   +++++   +++++   +   +++++   +
+       +   +   +   +   +   +            +   +   +   +   +   +   +
+++++   +   +   +   +   +   +   ++++++   +   +   +   +   +   +   +
+           +           +       +            +           +       +
++++++ ++++++   ++++++++++++ ++++++++++ ++++++   ++++   ++++++++++
+           +                   +            +                   +
+++++++++   +   ++++  +++++++   ++++++++++   +   +++  ++++++++   +
+           +   +       +                    +   +       +       +
+   +++++++++   +++++   +   ++++++   +++++++++   +++++   +   +++++
+           +       +   +       +            +       +   +       +
+++++++++   +++++   +   +++++   ++++++++++   +++++   +   +++++   +
+   +       +   +   +   +            +       +   +   +   +       +
+   +   +++++   +   +   +   +   ++   +   +++++   +   +   +   +   +
+   +   +               +   +        +   +               +   +   +
+   +   +++++++++++++++++   +   ++   +   +++++++++++++++++   +   +
+       +           +       +            +           +       +   +
+   +++++   +++++   +   +++++   ++   +++++   +++++   +   +++++   +
+       +   +   +   +   +   +   +        +   +   +   +   +   +   +
+++++   +   +   +   +   +   +   ++++++   +   +   +   +   +   +   +
+           +           +       +            +           +       +
++++++++++++++++++++++++++++++++++++++++++++++++++++++++++++++++++
